******XXXX
X****XXX**
XXX*****XX
**XXXX*XXX
**XXXX*XXX
XX*****XX*
X**XXX*XX*
*XXXXX*XX*
XXXX***XX*
XXXXX*****
