*****XX*XX
***XXXX***
X**XX***XX
****XXXXX*
XXX*XXXXX*
XX******XX
*XX**XX**X
XXXXXXX***
XXXXXXXX**
XXXX***XX*