**XX*XXXXX
*****XX*XX
***XXXX***
*****XXXX*
XXX****XXX
***XXX**XX
*XXXXX****
*XX**XXXX*
**********
XXXXX**XX*