**XXXXX*XXXXX*******
****XXXXXXX*****XXXX
XX*****XXXXXX**XX*XX
XX****XX******XXXX**
X*XX*********XXXXXX*
*XXX***XXX*XXXX**XX*
XXXXXX*****XXXXXXXX*
XXXX**XXX***XXX*XXXX
XXXXXXXXXXX**XXXXXX*
XXXXXXXXXXXX*XXXXX**
XX***XXXXXXX*XX*XXXX
XXXXXX*XXXX****XXXXX
*XXXXXXX*XXXXX**XX**
XXXXXXXX*XXX********
X*XXXXXXXXXX*XX*****
*XXXX*XXX**XXXXXX***
XXXX**XXXXXX*XXX*XX*
XXXXX**XXXX***XXXXX*
X*****XXXX*XXXXXXX**
**XXXXXXXXXXXX******
XXXXXXXXXXXXX****XX*
XXXXXXXXXXXXXX******
X*XXXX*XXXXXXXXX*XX*
*****XXXXXXXXXXXXX**
***XXXXXXX**XX******
***XXXXXX******XX***
XXX**XXX*XXX********
**XXXXXX**XXXXXX****
*XXXXXXX**XXXXXXXXX*
XXXXX***XXXXXXXXX***